1111111111111
1C01000E000C1
1000011100001
1P001100000C1
1111111111111
