1111111111111
1001000000C01
10CC011111001
1P0011E000001
1111111111111